R 1024 720
SO ./textures/lava.XPM
WE ./textures/gold.XPM
EA ./textures/green.XPM
S  ./textures/fox on white.XPM
NO ./textures/ice.XPM
F 	139 121 94
C 	65 105 225

111111111111111111111111
100000000000000000000001
1000000000000W0000000001
100000000200000000000001
1000000000100001200000011111111
1020000000000000000000000000001
1020000000000000000000000000021
1020000000000000000000000000001
1000000000100001000000011111111
100000000200000020000001
100000000000000000000001
100000000000000000000001
111111111111111111111111